token = BOT_TOKEN_HERE

owner = adminid

prefix = "!"


game = "specialscript.com"

status = ONLINE


songinstatus=false


altprefix = "NONE"



success = "🎶"
warning = "💡"
error = "🚫"
loading = "⌚"
searching = "🔎"

help = help

npimages = false


stayinchannel = false


maxtime = 0


playlistsfolder = "Playlists"


updatealerts=true



lyrics.default = "A-Z Lyrics"


aliases {
  settings = [ status ]

  lyrics = [ söz ]
  nowplaying = [ np, current ]
  play = [ ara ]
  playlists = [ pls ]
  queue = [ list ]
  remove = [ sil ]
  scsearch = []
  search = [ ytsearch ]
  shuffle = []
  skip = [ voteskip ]

  prefix = [ setprefix ]
  setdj = []
  settc = []
  setvc = []

  forceremove = [ forcedelete, modremove, moddelete ]
  forceskip = [ modskip ]
  movetrack = [ move ]
  pause = [ duraklat ]
  playnext = [ geç ]
  repeat = [ tekrarla ]
  skipto = [ atla ]
  stop = [ dur ]
  volume = [ vol, ses ]
}

eval=false
